BANDANA LEVEL
----------------------------------------
File created with Bandana level editor.
To play the level, put it into the 'userlevels'
subdirectory. To edit it, place this file into
the 'mylevels' directory.
MapFileVersion:1
Dimensions: 67,21

Author: Giovanni
Description:

endDescription

Background:
------------------------------------------------------------------
------------------------------------------------------------------
------------------------------------------------------------------
------------------------------------------------------------------
------------------------------------------------------------------
------------------------------------------------------------------
------------------------------------------------------------------
------------------------------------------------------------------
------------------------------------------------------------------
------------------------------------------------------------------
------------------------------------------------------------------
------------------------------------------------------------------
------------------------------------------------------------------
------------------------------------------------------------------
------------------------------------------------------------------
------------------------------------------------------------------
------------------------------------------------------------------
------------------------------------------------------------------
------------------------------------------------------------------
------------------------------------------------------------------
endBackground

Ground:
----------------------------dddddddddddddddddddddddddddddddddddddd
----------------------------d-----------------------2--------ddddd
----------------------------d--ddd-ddddddddd--------2---------dddd
----------------------------d--------------dddd-----2-----------dd
----------------------------dddddd------------d-----2-----------dd
---------------------------------d------------d-----2-ggggg------d
----------2----------------------ddddddddd----d-----2--gg--------d
----------2----------------------2------------d-----2------------d
----------2-------------2---2----2------------d-----2------------d
----------2-------------2---2----222222-------d-----2------------d
----------222222222-----2---2---------2-------d-----2------------d
------------------------2---2---------2-------d-------------------
------------------------2---2---------2-------2-------------------
------------------------2---2---------2-------2-------------------
---------------2--------2---2-----------------2-------------------
---------------2--------2---2-----------------2-------------------
--ggg-------------------2---2-----------------2-------------------
------------------------2---2-----------------2-------------------
------------------------------------------------------------------
222222222222222222222222222222222222222222222222222222222222222---
endGround

BgObjects:
endBgObjects

Objects:
Obj:Walker
	x:1
	y:18
	p:type=bouncy
	p:direction=1
	p:strength=23
endObj
Obj:Walker
	x:4
	y:18
	p:type=bouncy
	p:direction=1
	p:strength=16
endObj
Obj:Player
	x:3
	y:15
	p:bandana=green
endObj
Obj:Exit
	x:56
	y:4
endObj
Obj:Rotator
	x:34
	y:2
	p:rOuter=4
	p:rInner=1
	p:nArms=1
	p:angle=3.1415926535898
	p:speed=1
endObj
Obj:ParallaxConfig
	x:20
	y:19
	p:location=3
	p:color=blue
endObj
endObjects

