BANDANA LEVEL
----------------------------------------
File created with Bandana level editor.
To play the level, put it into the 'userlevels'
subdirectory. To edit it, place this file into
the 'mylevels' directory.
MapFileVersion:1
Dimensions: 49,21

Author: Giovanni
Description:

endDescription

Background:
------------------------------------------------
------------------------------------------------
------------------------------------------------
------------------------------------------------
------------------------------------------------
------------------------------------------------
------------------------------------------------
------------------------------------------------
------------------------------------------------
------------------------------------------------
------------------------------------------------
------------------------------------------------
------------------------------------------------
------------------------------------------------
------------------------------------------------
------------------------------------------------
------------------------------------------------
------------------------------------------------
------------------------------------------------
------------------------------------------------
endBackground

Ground:
------------------------------------------------
------------------------------------------------
------------------------------------------------
------------------------------------------------
------------------------------------------------
------------------------------------------------
------------------------------------------------
------------------------------------------------
---ooo-o--o-oo----ooo-ooo---oo--ooo-o---o-ooo---
---o---oo-o-o-o---o-o-o-----o-o-o---oo-oo-o-o---
---oo--o-oo-o-o---o-o-oo----o-o-oo--o-o-o-o-o---
---o---o--o-o-o---o-o-o-----o-o-o---o---o-o-o---
---ooo-o--o-oo----ooo-o-----oo--ooo-o---o-ooo---
------------------------------------------------
------------------------------------------------
------------------------------------------------
------------------------------------------------
------------------------------------------------
------------------------------------------------
------------------------------------------------
endGround

BgObjects:
endBgObjects

Objects:
Obj:Player
	x:4
	y:7
	p:canHook=true
	p:canParachute=true
	p:canTeleport=true
	p:canWalljump=true
endObj
endObjects

